NO /home/girts/Documents/cube3d/textures/N.png
SO /home/girts/Documents/cube3d/textures/E_2.png
WE /home/girts/Documents/cube3d/textures/W.png
EA /home/girts/Documents/cube3d/textures/E.png

F 50,50,50
C 100,50,50

111111111111111111111111111111111111
100000000000000100000000000000000001
100000000000000100000000000000000001
100111111000000100001110000111000001
100100001000000100001010000101000001
100100001000000000001010000101000001
100100001000000100001110000111000001
100110011000000100000000000000000001
100000000000000111111111011111111001
100000000000000000000000000000000001
1000N0000000000000000000000000000001
100000000000000111111111011111111111
100110011000000100000001010000000001
100100001000000100000001010000000001
100100001000000100000000000000000001
100100001000000100000001010000000001
100111111000000100000001010000000001
100000000000000111111111011111111111
100000000000000000000000000000000001
100100000010000001000000100000010001
100000000000000000000000000000000001
100100000010000001000000100000010001
100000000000000000000000000000000001
111111111111111111111111111111111111
