NO   textures/main/N.png
SO         textures/main/S.png

   WE textures/main/W.png
EA    textures/main/E.png

F  0,51,25
C    102,51,0


111111111111111111111111111111111
100000000000000000000000000000001
101100000111000000000000000000001
100100000111111111111111000000001
1111100111             1000000001
1000000001             1111101111
1111011111             1100000001
1111011111             1100000001
110000001111111111111111100000001
10000000000000000000000000000N001
100000000000000011010100100000001
111111111111111111111111111111111




