NO .test/image.png
SO         .test/image.png

   WE .test/image.png
EA    .test/image.png

F  220,100,0
C    225,30,0


111111111111111111111111111111111
100000000011000000000000000000001
101100000111000000000000000000001
100100000111111111111111000000001
1111111111             1000000001
1000000001             1111111111
1111011111             1100000001
1111011111             1100000001
110000001111111111111111100000001
10000000000000001100000010000N001
100000000000000011010100100000001
111111111111111111111111111111111




