NO   textures/main/N.png
SO         textures/main/S.png

   WE textures/main/W.png
EA    textures/main/E.png

F  0,51,25
C    102,51,0


   111111
   100001
   100001
   111111     111111
              100001
              100001
              111111
111111  111111
100S01  100001
111111  111111      11
                  111111
