NO .test/image.png
SO         .test/image.png

   WE .test/image.png
EA    .test/image.png

F .test/image.png

C .test/image.png

                                     1
    111111111111111111111111111111111S1
                                     1



