NO   textures/main/N.png
SO         textures/main/S.png

   WE textures/main/W.png
EA    textures/main/E.png

F  0,51,25
C    102,51,0

                                     1
    111111111111111111111111111111111S1
                                     1



