NO .test/image.png
SO         .test/image.png

   WE .test/image.png
EA    .test/image.png

F  220,100,0
C    225,30,0

                                     1
    111111111111111111111111111111111S1
                                     1



