NO   textures/main/N.png
SO         textures/main/S.png

   WE textures/main/W.png
EA    textures/main/E.png

F  0,51,25
C    102,51,0


        1111111111111111111111
        1000000000000000000001
        10000000000S0000000001
        1000000000000000000001
        1000000000000000000001
        1000000000000000000001
        1000000000000000000001
        1000000000000000011111
        1000000000000000000001
        1111111110000000000001
        1000000000000000000001
        1111110000000000000001
        1000000000000000000001
        1000000000000000000001
        1000000000000000000001
        1000000000000000000001
        1000000000000000000001
        1000000000000000000001
        1111111110000000000001
        1000000010000000000001
        1000000010000000000001
        1000000010000000000001
        1000000010000000000001
        1000000010000000000001
        1000000010000000000001
        1000000010000000000001
        1000000010000000000001
        1000000010000000000001
        1000000010000000000001
        1000000010000000000001
        1000000010000000000001
        1000000010000000000001
        1000000011110000000001
        1000000000000000000001
        1000000000000000000001
        1000000000000000000001
        1000000000000000000001
        1000000000000000000001
        1000000000000000000001
        1000000000000000000001
        1000000000000000000001
        1000000000000000000001
        1000000000000000000001
        1000000000000000000001
        1000000000000000000001
        1000000000000000000001
        1000000000000000000001
        1000000000000000000001
        1000000000000000000001
        1000000000000000000001
        1000000000000000000001
        1000000000000000000001
        1000000000000000000001
        1000000000000000000001
        1000000000000000000001
        1000000000000000000001
        1000000000000000000001
        1000000000000000000001
        1000000000000000000001
        1000000000000000000001
        1000000000000000000001
        1000000000000000000001
        1000000000000000000001
        1000000000000000000001
        1000000000000000000001
        1000000000000000000001
        1000000000000000000001
        1000000000000000000001
        1000000000000000000001
        1000000000000000000001
        1000000000000000000001
        1000000000000000000001
        1000000000000000000001
        1000000000000000000001
        1000000000000000000001
        1000000000000000000001
        1000000000000000000001
        1000000000000000000001
        1000000000000000000001
        1000000000000000000001
        1000000000000000000001
        1000000000000000000001
        1000000000000000000001
        1000000000000000000001
        1000000000000000000001
        1000000000000000000001
        1000000000000000000001
        1000000000000000000001
        1000000000000000000001
        1000000000000000000001
        1000000000000000000001
        1000000000000000000001
        1000000000000000000001
        1000000000000000000001
        1111111111000111111111
        1000000000000000000001
        1000000000000000000001
        1000000000000000000001
        1000000000000000000001
        1000000000000000000001
        1000000000000000000001
        1000000000000000000001
        1000000000000000000001
        1000000000000000000001
        1000000000000000000001
        1000000000000000000001
        1000000000000000000001
        1000000000000000000001
        1000000000000000000001
        1000000000000000000001
        1000000000000000000001
        1000000000000000000001
        1000000000000000000001
        1000000000000000000001
        1000000000000000000001
        1000000000000000000001
        1000000000000000000001
        1000000000000000000001
        1000000000000000000001
        1000000000000000000001
        1000000000000000000001
        1000000000000000000001
        1000000000000000000001
        1000000000000000000001
        1000000000000000000001
        1000000000000000000001
        1000000000000000000001
        1000000000000000000001
        1000000000000000000001
        1000000000000000000001
        1000000000000000000001
        1000000000000000000001
        1000000000000000000001
        1000000000000000000001
        1000000000000000000001
        1000000000000000000001
        1000000000000000000001
        1000000000000000000001
        1000000000000000000001
        1000000000000000000001
        1000000000000000000001
        1000000000000000000001
        1000000000000000000001
        1000000000000000000001
        1000000000000000000001
        1000000000000000000001
        1000000000000000000001
        1000000000000000000001
        1000000000000000000001
        1000000000000000000001
        1000000000000000000001
        1000000000000000000001
        1000000000000000000001
        1000000000000000000001
        1000000000000000000001
        1000000000000000000001
        1000000000000000000001
        1000000000000000000001
        1000000000000000000001
        1000000000000000000001
        1000000000000000000001
        1000000000000000000001
        1000000000000000000001
        1000000000000000000001
        1000000000000000000001
        1000000000000000000001
        1000000000000000000001
        1000000000000000000001
        1000000000000000000001
        1000000000000000000001
        1000000000000000000001
        1000000000000000000001
        1000000000000000000001
        1000000000000000000001
        1000000000000000000001
        1000000000000000000001
        1000000000000000000001
        1111111111111111111111
